111111
1CEP01
111011
111011
1C1P11
111111
