111111
1CEP01
111011
111011
1C0011
111111
