11111
1C0P1
10001
11111
10E01
11111
