111111
10EP01
111011
111011
1C0011
111111
