11111111111111111
1P000000110000001
1PC0E000000000001
10000110000011001
10000000001000001
11111111111111111
