11111111111111111111111
10P011100000000000000E1
10000000000000001111111
10000011111100000001101
100G0000000011111000C01
10000000011111000000111
100DD00C000C00000011001
10000000000000011111111
10000000C00000000000001
11111111111111111111111
