11111111111111111
10P00000110000111
10000000000000001
1000011000C011001
10C0000000C000001
1111111111111111
