11111111111111111
10000000110000001
19P0000E000000001
1000011000C011001
10C0000000C000001
11111111111111111
