11111111111111111
1PE00000110000001
10C00000000000001
10000110000011001
10000000001000001
11111111111111111
